Ice race: ice_race, ir
Slow Race: slow_race, sr
Nether Race: nether_race, nr
Evil Race: evil_race, evilr
Diamond Race: diamond_race, dr
Emerald Race: emerald_race, er
Quartz Race: quartz_race, qr
1.8 Race: 1_8_race, 18r
Epic Race: epic_race, epicr
Salt Race: salt_race, saltr
Death Run: death_run, deathr
Dirt Race: dirt_race, dirtr
Mycelium Race: mycelium_race, mr
Frostburn Run: frostburn_run, fbr
EverChanging Race: ever_changing_race, ecr
Virus 1: virus_1, virus1, vr1
Virus 2: virus_2, virus2, vr2
PVP: Old CTF: pvp, pvp1, oldctf
Capture the flag: capture_the_flag, ctf
The Pit 3: the_pit_3, tp, tpl3
Sand Tomb: sand_tomb, st
Anvil Drop: anvil_drop, ad
Death Pit: death_pit, dp
Rabbit Ball: rabbit_ball, rb
Mastermind: mastermind, mm
Pictionary: pictionary, pc
Royal Rumble: royal_rumble, rr
A Small Village: bh_a_small_village, bhasv
Apocalypse: bh_apocalypse, bha
Castle de Emmy: bh_castle_de_emmy, bhcde
Four Corners: bh_four_corners, bhfc
HASDaa: bh_hasdaa, bhhd
Hospital: bh_hospital, bhh
Jungle: bh_jungle, bhj
Mastermind: bh_mastermind, bhm, bhmm
Mushroom Village: bh_mushroom_village, bhmv
Old: bh_old, bho
Park: bh_park, bhp
Rainbow: bh_rainbow, bhra
Resort: bh_resort, bhre
Train Station: bh_train_station, bhts
BH Virus 1: bh_virus_1, bhvr1
BH Virus 2: bh_virus_2, bhvr2
Zelda: bh_zelda, bhz
Spawn: spawn
Floo Network: floo_network, cmd, floo, diagonally
Teamspeak Token: ts_token, ts, tstoken
The Minigame Hub: mghub
The PVP hub: pvphub
The Mastermind Hub: mmhub
The Race Hub: racehub
